w	w	w	w	w	w	w	w	w	w	w	w	w	w	w	w	w	w	w	w	w	w	w	w	w	w	w
w	0	s	0	S	S	S	0	0	0	0	0	B	B	0	0	0	0	0	0	0	0	0	0	0	0	w
w	0	w	0	w	S	w	0	w	0	w	0	w	0	w	0	w	0	w	0	w	0	w	0	w	0	w
w	F	0	0	0	0	0	0	0	0	0	0	0	0	0	0	0	0	0	0	0	0	0	0	0	0	w
w	0	w	0	w	0	w	0	w	0	w	0	w	0	w	0	w	0	w	0	w	0	w	0	w	0	w
w	0	0	0	0	0	0	0	0	0	S	S	0	0	0	0	0	0	0	0	0	0	0	0	0	0	w
w	0	w	0	w	0	w	0	w	0	w	0	w	0	w	0	w	0	w	0	w	0	w	0	w	0	w
w	0	0	0	0	0	0	0	0	0	0	0	0	0	0	0	0	0	0	0	0	0	0	0	0	0	w
w	0	w	0	w	0	w	0	w	0	w	0	w	0	w	0	w	0	w	0	w	0	w	0	w	0	w
w	0	0	0	0	0	0	0	0	0	0	0	0	B	0	0	0	0	0	0	0	0	0	0	0	0	w
w	0	w	0	w	0	w	0	w	0	w	0	w	0	w	B	w	0	w	0	w	0	w	0	w	0	w
w	0	0	0	0	0	0	0	0	0	0	0	0	0	0	0	0	0	0	0	0	0	0	0	0	0	w
w	w	w	w	w	w	w	w	w	w	w	w	w	w	w	w	w	w	w	w	w	w	w	w	w	w	w